20 10
11111111111e11111111
11000001111011111111
11011111100000011011
11000000001111011011
11010111101111000011
11000001100000011111
11110111110111111111
11110111010111111111
11110000000000000011
11111x11111111111111